姜孝慈	蔣祿青	子
嬰靈	祝紅	母亲
黃國禎	黃國銘	兄
黃前鋒	黃國銘	子
黃江川	黃棟樑	子
黃王汝	黃棟樑	子
黃陳勉	黃健哲	孫
黃堅	黃健哲	孫
嬰靈	黃芝華	母亲
楊宗雄	楊景貴	姪女
楊召祥	楊景貴	姐
楊氏男嬰	楊景貴	妹
嬰靈	張佳音	母亲
丁詩敏	姜孝靖	夫
楊平	楊應欽	孫
楊陳引	楊應欽	孫
楊榮華	楊宏元	孫
楊蔡盞	楊宏元	孫
黃泗濱	黃湉惠	女
張萬生	張天詳	子
林梅雪	張天詳	子
黃雅雲	黃健哲	弟
姜孝若	高瑩	妻
林松藤畜牧場豬靈	林松藤	主人
嬰靈	楊應欽	母亲
楊榮華	楊應欽	子
楊蔡盞	楊應欽	子
林編	林容達	孫
林康色珠	林容達	子
黃江川	黃國銘	孫
黃王汝	黃國銘	孫
嬰靈	林夢茜	母亲
莊陳蔭	莊永松	孫
楊陳盆	楊正雄	子
嬰靈	黃國銘	母亲
黃水得	黃國欽	玄孫
黃呂賢	黃國欽	玄孫
梁清西	梁暉煌	孫
梁王粉	梁暉煌	孫
梁育倫	梁瑋庭	姪女
黃翠粧	林金容	夫
林傳福	林金容	子
林献	林金容	子
黃田螺	姚沛盈	侄孫媳
陳啟霖	陳依君	女
松藤畜牧場豬靈	楊妮姍	主人
集美畜牧場豬靈	楊妮姍	主人
蕭廷章	蕭高秀鑾	媳
蕭游綢	蕭高秀鑾	媳
張萬生	張佳音	孫女
林梅雪	張佳音	孫女
李稻	黃韻如	子孫
嬰靈	黃雅美	母亲
康模	康振凱	子
林松泉畜牧場豬靈	林容達	主人
林明裕畜牧場豬靈	林容達	主人
黃泗濱	黃芝華	女
莊金月	黃國銘	子
林許縣	林松藤	子
林雲	楊妮姍	曾孫媳
林蔡鶯	楊妮姍	曾孫媳
吳桂焦	吳為吉	孫
集美加工飼料豬靈	林松藤	主人
黃國書	黃國銘	兄
楊琴	楊協和	子
蕭玉富	蕭文琴	女
謝朝木	謝淵貴	子
陳錦智	陳阿粉	女
楊嘉慶	楊祥霖	子
陳素秋	莊永松	夫
先祖父	蔣祿青	孫
先祖母	蔣祿青	孫
黃金	釋會惇	子孫
黃嫌	釋會惇	子孫
呂崁	黃麗鈴	子孫
呂林匏	黃麗鈴	子孫
黃信子	黃國洲	侄子
黃靜子	黃國洲	侄子
楊興	楊正雄	子
王瓜子	黃健哲	外孫
王楊瓜	黃健哲	外孫
張世穗	張婉惇	女
張天爵	黃薏珊	孫女
黃江川	黃健哲	子
黃王汝	黃健哲	子
鄭陳勉	鄭月梅	孫女
鄭模松	鄭月梅	女
鄭炳煌	鄭月梅	孫女
檀姣雲	檀金海	子
李繼恩	李述蘭	女
黃雅雲	李述蘭	女
曾龍英	李繼周	子
李子實	李繼周	子
嬰靈	李述蘭	母亲
林麗卿	林彥主	姐
嬰靈	蕭文琴	母亲
陳春燈	陳啟文	子
陳廖來	陳啟文	子
楊寬夫婦	楊照民	子
陳榮東	黃雅美	孫媳
陳侯蜜	黃雅美	孫媳
嬰靈	姚沛盈	母亲
先祖父	施永淳	孫
先祖母	施永淳	孫
許有財	許錫文	弟
先父	許錫文	子
先母	許錫文	子
嬰靈	許錫文	母亲
陳建仲	陳仕昌	兄
嬰靈	黃湫茹	母亲
吳桂焦	林彥主	女
吳黃奈	林彥主	女
黃江川	姚沛盈	媳
黃王汝	姚沛盈	媳
嬰靈	林松藤	母亲
姚阿漢	姚次郎	子
姚林足	姚次郎	子
黃生夫婦	黃國洲	子孫
嬰靈	蔣中元	母亲
莊地	莊顏玉隊	媳
莊達	莊顏玉隊	妻
嬰靈	莊顏玉隊	母亲
陳住	陳勝煙	子
黃國禎	黃國銘	兄
黃前鋒	黃棟樑	兄
康模	康振忠	子
高天成	高秀鑾	女
高許玉蘭	高秀鑾	女
楊秀琴	楊源豊	子
楊萬賜夫婦	楊源豊	子
楊茂雄	楊源豊	弟
吳黃奈	吳為吉	孫
陳蘇放	陳氏後裔	子孫
許黃雅雲	許錫文	夫
楊施丹	楊宗仕	子
謝趙查某	謝淵貴	子
陳林月女	陳阿粉	女
楊憨垂	楊錫賀	子
李清全	李忠穎	子
嬰靈	康吳寡	母亲
