釋會惇	黃
楊振昇	楊
楊宏元	楊
姜慧	張
黃棟樑	黃
黃國銘	黃
黃健哲	黃
張天詳	張
黃國欽	黃
楊景貴	楊
楊沛沛	蔣
檀金海	檀
張婉惇	張
林奕增	林
蔣宗宸	蔣
黃仁泰	黃
李繼周	李
黃棟樑	呂
吳為吉	吳
黃韻如	黃
楊振東	楊
楊錫賀	楊
姚沛盈	黃
蔣祿青	蔣
林容達	林
姜江	姜
陳啟文	陳
楊協和	楊
蔣祿松	蔣
楊應欽	楊
蔣中元	蔣
林松藤	林
黃健哲	王
黃國洲	黃
李述蘭	李
莊永松	莊
高秀鑾	高
楊源豊	楊
楊照民	楊
楊子瑋	楊
康吳寡	康
林榕資	黃
黃芝華	黃
楊妮姍	林
施永淳	施
林金容	林
黃麗鈴	呂
陳依君	陳
姚俊義	姚
檀忠民	檀
蔣浩宏	蔣
李忠穎	李
楊睿展	楊
姚通吉	姚
黃志明	黃
許蘭英	許
楊正雄	楊
莊戊彬	莊
楊祥霖	楊
林稚閔	林
陳勝煙	陳
黃薏珊	張
許錫文	許
梁暉煌	梁
蔣涵儀	婁
許蘭英	張
姚次郎	姚
祝紅	祝
林彥主	吳
鄭月梅	鄭
姜孝靖	姜
蕭文達	蕭
吳金珠	吳
莊文吉	莊
林夢茜	林
張繼鵬	張
法蘭西斯卡	西斯卡
曾威箖	曾
楊宗仕	楊
